NO assets/door.xpm
SO assets/door.xpm
WE assets/door.xpm
EA assets/door.xpm
F 220,100,0
C 00,0,0
1111111111111111111111111
1000000000000000000000001
1011111110111111110111101
1000000010000000010000001
1011111010111111010111101
1000001010000001010000001
1011101010111111010111101
100010001000N000100000001
1110101110111011101111011
1000100000100010001000001
1011101111101111011110111
1000001000000000100000001
1011111011111111011111101
1000000000000000000000001
1111111111111111111111111
