NO NOoo
SO SOoo
WE WEee
EA EAaa
F 220,100,0
C 00,0,0
11111
11N11
111110